111111111111
100000000001
111E10000001
10111P000001
1000000N0001
111111111111