111111111111
100000000001
1000C1000001
10001E100001
1000010P0001
111111111111