1111111111111111
1C0000C0010000C1
1000000100P01111
110C010001000001
1E00C00010000C01
100001CC00000001
1000000000000001
1111111111111111