1111111111111111111111111
1C0000C001000000000000001
1000000001P0111000Q000001
1111110001000011111111101
1000C000000000Q00001EC001
1111111111111111111111111