1111111111111
100C000P000E1
1111111111111