111111111111111111111111111111111111111
100C000011000000000000001110000000010E1
100000000000000000011100111011110000011
11111100000P00000001110011101C010000011
10C000000000000000011C00111011010000001
111111110010001101111111111000010001001
111111110001111000111111111E00010000011
100C0000010000000E000000000111110000111
111111111111111110000000110110000000001
1C1111101111101110011110000000000001011
10000000000000000011C000111110000001C11
111111111111111111111111111111111111111