1111111111111111
1C0000C0010000C1
1000000100P01111
110C010001000001
1E00C00010000001
100001CC00001C11
1000000000000101
1111111111111111