11111111111111111
1CCCCCCCCCCCCCCC1
1CCCCPCCCCCCCCCC1
1CCC111111111CCC1
1CCC100000001CCC1
1CCC100000001CCC1
1CCC100000001CCC1
1CCC111111111CCC1
1CCCCCCCCCCCCC111
1CCCCCCCCCCCCC0E1
11111111111111111