111111111111111111111111111111111111111
100C000011000000000000001110000000100C1
100000010100000000011100111011110010111
11111100000P00000001110011101C010010111
10C000000010000000011C001110110100101C1
111111110010001101111111111001010001001
111111110001111000111111111000010000011
100C0000010000000E000000001111110000111
111111111111111110000000111110010000001
1C1111101111101110011110010000000001011
10000000100000000011C000111110000001C11
111111111111111111111111111111111111111