111111111111111111111111111111111111111
100E00001100000000111110000000N00100001
10000000CC000000000000001110000N0001001
1111110000000000P0111001111000000101001
10E0N0000000000000P1100011000C0C0011001
11111111001000110111111000010C000100001
1111111100011110001111100110C00C0000001
100E00001100000000000000011100000011001
10000000CC00000000111P00110C00C01000011
11111100000000N0000111000111000N0101001
10E000010000000000011000111100000101001
111111111111111111111111111111111111111